0 0 0 0 0 0 0 0 0
0 1 1 2 0 0 0 0 0
0 1 2 2 1 0 0 0 0
0 0 2 3 3 1 0 0 0
0 0 0 2 3 3 1 0 0
0 0 0 1 1 1 1 0 0
0 0 1 1 2 2 1 1 1
0 0 1 2 5 3 4 1 0
0 0 1 2 2 2 1 1 0
0 1 1 3 3 1 1 0 0
0 1 2 3 3 3 0 0 0
0 0 1 1 1 1 0 0 0
0 0 0 5 0 0 0 0 0
0 0 0 0 0 0 0 0 0
